NO ./images/north.xpm
SO ./images/south.xpm
WE ./images/west.xpm
EA ./images/east.xpm


F 170,170,170
C 250,60,20

        1111111111111111111111111
   111111000000000110000000000001
   10DDDD011000001110000000000011
   101111001000000000000000000001
111111111011000001110000000000001
100000000011100001110111111111111
11110111111 11011100000010001
11110111111111011101010010001
11000000110101011100000010001
100000000000000011000000D0d01
10000000000000001101010010001
11000001110101011111011111o1111
11110111 1110101 101111011N11
11111111 1111111 111111111111